/--------------------------------------\  /--------------------------------------\
|  .  .  .  .  .  .  .  .  .  .  .  .  |  |  .  .  .  .  .  .  .  .  .  .  .  .  |
|  .  /--------\  .  /-----------\  .  |  |  .  /-----------\  .  /--------\  .  |
|  *  |        |  .  |           |  .  |  |  .  |           |  .  |        |  *  |
|  .  \--------/  .  \-----------/  .  \--/  .  \-----------/  .  \--------/  .  |
|  .  .  .  .  .  .  .  .  .  .  .  .  .  .  .  .  .  .  .  .  .  .  .  .  .  .  |
|  .  /--------\  .  /--\  .  /--------------------\  .  /--\  .  /--------\  .  |
|  .  \--------/  .  |  |  .  \--------\  /--------/  .  |  |  .  \--------/  .  |
|  .  .  .  .  .  .  |  |  .  .  .  .  |  |  .  .  .  .  |  |  .  .  .  .  .  .  |
\--------------\  .  |  \--------\     |  |     /--------/  |  .  /--------------/
               |  .  |  /--------/     \--/     \--------\  |  .  |               
               |  .  |  |                                |  |  .  |               
               |  .  |  |     /-----__________-----\     |  |  .  |               
---------------/  .  \--/     |                    |     \--/  .  \---------------
                  .           |        X  X        |           .                  
---------------\  .  /--\     |                    |     /--\  .  /---------------
               |  .  |  |     \--------------------/     |  |  .  |               
               |  .  |  |                                |  |  .  |               
               |  .  |  |     /--------------------\     |  |  .  |               
/--------------/  .  \--/     \--------\  /--------/     \--/  .  \--------------\
|  .  .  .  .  .  .  .  .  .  .  .  .  |  |  .  .  .  .  .  .  .  .  .  .  .  .  |
|  .  /--------\  .  /-----------\  .  |  |  .  /-----------\  .  /--------\  .  |
|  .  \-----\  |  .  \-----------/  .  \--/  .  \-----------/  .  |  /-----/  .  |
|  *  .  .  |  |  .  .  .  .  .  .  .        .  .  .  .  .  .  .  |  |  .  .  *  |
\-----\  .  |  |  .  /--\  .  /--------------------\  .  /--\  .  |  |  .  /-----/
/-----/  .  \--/  .  |  |  .  \--------\  /--------/  .  |  |  .  \--/  .  \-----\
|  .  .  .  .  .  .  |  |  .  .  .  .  |  |  .  .  .  .  |  |  .  .  .  .  .  .  |
|  .  /--------------/  \--------\  .  |  |  .  /--------/  \--------------\  .  |
|  .  \--------------------------/  .  \--/  .  \--------------------------/  .  |
|  .  .  .  .  .  .  .  .  .  .  .  .  .  .  .  .  .  .  .  .  .  .  .  .  .  .  |
\--------------------------------------------------------------------------------/
