               |     |     |     |     |     |     |     |               
   /-----------/     \-----/     \-----/     \-----/     \-----------\   
   |  .  .  .  .  .  .  .  .  .  .  .  .  .  .  .  .  .  .  .  .  .  |   
   |  .  /-----\  .  /-----\  .  /-----\  .  /-----\  .  /-----\  .  |   
   |  *  |     |  .  |     |  .  |     |  .  |     |  .  |     |  *  |   
---/  .  \-----/  .  \-----/  .  \-----/  .  \-----/  .  \-----/  .  \---
      .  .  .  .  .  .  .  .  .           .  .  .  .  .  .  .  .  .      
---\  .  /-----\  .  /-----\     /-----\     /-----\  .  /-----\  .  /---
   |  .  |     |  .  |     |     |     |     |     |  .  |     |  .  |   
---/  .  \-----/  .  \-----/     \-----/     \-----/  .  \-----/  .  \---
      .  .  .  .  .  .  .  .                 .  .  .  .  .  .  .  .      
---\  .  /-----\  .  /-----\     /-----\     /-----\  .  /-----\  .  /---
   |  .  |     |  .  |     |     |     |     |     |  .  |     |  .  |   
---/  .  \-----/  .  \-----/     \-----/     \-----/  .  \-----/  .  \---
      .  .  .  .  .  .  .  .                 .  .  .  .  .  .  .  .      
---\  .  /-----\  .  /-----\     /-----\     /-----\  .  /-----\  .  /---
   |  .  |     |  .  |     |     |     |     |     |  .  |     |  .  |   
---/  .  \-----/  .  \-----/     \-----/     \-----/  .  \-----/  .  \---
      .  .  .  .  .  .  .  .                 .  .  .  .  .  .  .  .      
---\  .  /-----\  .  /-----\     /-----\     /-----\  .  /-----\  .  /---
   |  .  |     |  .  |     |     |     |     |     |  .  |     |  .  |   
---/  .  \-----/  .  \-----/     \-----/     \-----/  .  \-----/  .  \---
      .  .  .  .  .  .  .  .  .           .  .  .  .  .  .  .  .  .      
---\  .  /-----\  .  /-----\  .  /-----\  .  /-----\  .  /-----\  .  /---
   |  *  |     |  .  |     |  .  |     |  .  |     |  .  |     |  *  |   
   |  .  \-----/  .  \-----/  .  \-----/  .  \-----/  .  \-----/  .  |   
   |  .  .  .  .  .  .  .  .  .  .  .  .  .  .  .  .  .  .  .  .  .  |   
   \-----------\     /-----\     /-----\     /-----\     /-----------/   
               |     |     |     |     |     |     |     |               
